WWWWWRRWWWWW
WWRWWRRWWRWW
RRRRRWRRRRRR
WWWWRRRRWWWW
WWWWRRRRWWWW
RRRRRRWRRRRR
WWRWWRRWWRWW
WWWWWRRWWWWW
