WRWWWRRWWWRW
RRRRRWWRRRWR
WRWWWRRWWWRW
RWRRRRWRRRWR
RWRRRWRRRRWR
WRWWWRRWWWRW
RWRRRWWRRRRR
WRWWWRRWWWRW